...........
.#.###.###.
.#...#...#.
.#.#####.#.
.#.....#.#.
##.###.###.
.....#.#.#.
.#.###.#.##
.#...#.....
########.##
...#.......
