...........
.#.###.###.
.#...#...#.
.#.#####.#.
.#.....#.#.
##.###.###.
.....#.#.#.
.#.###.#.##
.#...#.#...
##.#.###.##
...#.......
