...#.#.#.#.....
.###.#.#.#.#.##
...#.#...#.#.#.
##.#.#.###.###.
.........#.#.#.
.###.#####.#.#.
.#.............
####.#.#.###.##
.....#.#...#...
####.#.#.#.###.
.....#.#.#...#.
.#.#.###.###.##
.#.#.#.....#...
.#######.###.#.
.#.........#.#.
